ğŸ“ General Instructions / Structure
ğŸ“Œ	Important note / key instruction
ğŸ§­	Project navigation
ğŸ—‚ï¸	File or project structure
ğŸ§±	Application module / layer

ğŸ› ï¸ Development & Build
ğŸ§ª	Testing
ğŸ§°	Developer tools
ğŸ§¼	Cleaning (e.g., dotnet clean)
ğŸ—ï¸	Building (e.g., compile, migrate)
ğŸ§±	Compilation

ğŸ§ª Testing & Debugging
ğŸ	Bug / debugging
ğŸ”	Inspect / investigate
âŒ	Error / failed test
âœ…	Passed test / success

ğŸ³ Docker / Containerization
ğŸ§©	Microservice / component
ğŸ”Œ	Connection between containers
ğŸ“¦	Docker image

ğŸ’¾ Database / Migrations
ğŸ—ï¸	Create migration
ğŸ› ï¸	Update database
ğŸ“Š	Data / records

ğŸ§­ Running / Environments
â–¶ï¸	Run command (dotnet run, etc.)
ğŸ’»	Local machine (host)
ğŸ§	Linux / Unix
ğŸªŸ	Windows
ğŸ	macOS
ğŸ”	Restart / rerun

ğŸŒ Other / Networking / Configuration
ğŸŒ	Network / Internet
ğŸ”’	Security / authentication
ğŸ”§	Configuration
âš™ï¸	Settings
ğŸ“„	Config file (e.g., appsettings.json)
ğŸŒ±	Development environment
ğŸš€	Production / deployment

